**********
XXXX***X**
**********
**XX**XX**
*X*X***X**
***X***X**
**********
*XX**X*XXX
*****X***X
*X*X*XXX**